0
21
16
1
144
528
0
0
0
0
0
0
111 110 000 000 000 000 000 000 000 000 000 000 000 000 000 000 
111 110 000 000 000 000 000 000 000 000 000 000 000 000 000 000 
111 110 1e8 1e7 000 000 000 000 000 000 000 000 000 000 000 000 
111 110 1f8 1f7 000 000 000 000 000 000 000 000 000 000 000 000 
111 110 000 000 000 000 000 000 000 000 000 000 000 000 000 000 5
111 110 000 000 000 000 000 000 000 000 000 000 000 000 000 000 
111 110 000 000 000 000 000 000 000 000 000 000 000 000 000 000 
111 110 000 000 000 000 000 000 000 000 000 000 000 000 000 000 
111 110 000 000 000 000 000 000 000 000 000 000 000 000 000 102 
111 110 000 000 000 000 000 000 000 000 000 000 000 000 102 191 10
111 110 000 000 000 000 000 000 000 000 000 000 000 102 191 111 
111 110 000 000 000 000 000 000 000 000 000 000 000 112 111 111 
111 110 000 000 000 000 000 000 000 000 000 000 102 191 111 111 
111 110 000 000 000 000 000 000 000 000 000 000 112 111 111 111 
111 110 022 021 000 000 000 000 000 000 000 102 191 111 111 111 15
121 120 032 031 000 000 000 000 000 000 000 112 111 111 111 111 
002 002 082 081 002 81e 000 000 000 000 000 112 111 111 111 111 
012 012 092 091 012 81f 000 000 000 000 000 112 111 111 111 111 
101 101 101 101 101 101 101 101 101 101 101 191 111 111 111 111 
111 111 111 111 111 111 111 111 111 111 111 111 111 111 111 111 20
111 111 111 111 111 111 111 111 111 111 111 111 111 111 111 111 