1
174
16
2
144
600
3
192
240
0
0
0
114 114 114 114 114 114 114 114 114 114 114 114 114 114 114 114
114 114 144 124 124 124 124 124 124 124 124 124 124 124 124 124 
114 114 113 000 000 000 000 000 000 000 000 000 000 001 002 002 
114 114 113 000 000 000 000 000 000 000 000 000 000 011 012 012 
114 114 113 000 000 000 000 000 000 000 000 000 105 104 104 104 5
114 114 113 000 000 000 000 000 000 000 000 000 125 124 124 124 
114 114 113 000 000 000 000 000 000 000 000 000 000 804 000 000 
114 114 113 000 000 000 000 000 000 000 000 000 000 804 000 000 
114 114 113 000 000 000 000 000 000 000 000 000 000 804 000 000 
114 114 113 1d4 000 000 000 000 000 000 000 000 000 804 000 000 10
114 114 113 1e4 000 000 000 000 000 000 000 000 000 804 000 000 
114 114 113 000 000 000 801 000 000 000 000 000 000 804 000 000 
114 114 113 000 000 000 800 000 000 000 000 000 000 804 000 000 
114 114 113 000 000 000 800 000 000 000 000 000 000 804 000 000 
114 114 113 000 000 000 800 000 000 000 000 000 000 804 000 000 15
114 114 113 000 000 000 800 000 000 000 000 000 000 804 000 000 
114 114 113 000 000 000 000 000 000 000 000 000 000 804 000 000 
114 114 113 c01 000 000 000 000 000 000 000 000 000 804 000 000 
114 114 113 040 c01 000 000 000 000 000 000 000 000 804 000 000 
114 114 113 000 000 000 000 000 000 000 000 000 000 804 000 000 20
114 114 113 040 040 000 000 000 000 000 000 000 000 804 000 000 
114 114 113 000 000 000 000 000 000 000 000 000 000 804 000 000 
114 114 113 040 040 040 000 000 000 000 000 000 000 804 000 000 
114 114 113 000 000 000 000 000 000 000 000 000 000 804 000 000 
114 114 113 040 040 040 040 000 000 000 000 000 000 804 000 000 25
114 114 113 000 000 000 000 000 000 000 000 000 000 804 000 000 
114 114 113 040 040 040 040 000 000 000 000 000 000 804 000 000 
114 114 113 000 000 000 000 000 000 000 000 000 000 804 000 000 
114 114 113 040 040 040 000 000 000 000 000 000 000 804 000 000 
114 114 113 000 000 000 000 000 000 000 000 000 000 804 000 000 30
114 114 113 c01 000 000 000 80e 000 000 000 000 000 804 000 000 
114 114 113 1f5 000 000 000 000 000 000 000 000 000 804 000 000 
114 114 113 040 040 040 000 000 000 000 000 000 000 804 000 000 
114 114 113 000 000 000 000 000 000 000 000 000 000 804 000 000 
114 114 113 040 040 000 000 000 000 000 000 000 000 804 000 000 35
114 114 113 000 000 000 000 000 000 000 000 000 000 804 000 000 
114 114 113 000 000 000 000 000 000 000 000 000 000 804 000 000 
114 114 113 000 000 000 000 000 000 000 000 000 000 804 000 000 
114 114 113 000 000 000 000 000 000 000 000 000 000 804 000 000 
114 114 113 000 000 000 000 000 000 000 000 000 000 804 000 000 40
114 114 113 1d3 000 000 804 804 804 000 000 000 000 804 000 000 
114 114 113 1e3 000 000 804 81d 000 000 000 000 000 804 000 000 
114 114 113 1f3 000 000 804 804 804 000 81d 000 000 804 000 000 
114 114 113 000 000 000 000 000 804 000 81d 000 000 804 000 000 
114 114 113 000 000 000 000 000 804 000 81d 000 000 804 000 000 45
114 114 113 000 000 000 804 804 804 000 81d 000 000 804 000 000 
114 114 113 c02 000 000 804 81d 000 000 000 000 000 804 000 000 
114 114 113 c02 000 000 804 804 807 000 000 000 000 804 000 000 
114 114 113 000 000 000 000 000 000 000 000 000 000 804 000 000 
114 114 113 000 000 000 000 000 000 000 000 000 000 804 000 000 50
114 114 113 000 000 000 000 000 000 000 000 000 000 804 000 000 
114 114 113 000 000 000 000 000 000 000 000 000 000 804 000 000 
114 114 113 1d5 000 000 000 000 000 000 000 000 000 804 000 000 
114 114 113 1e5 000 000 804 804 804 804 804 804 804 804 000 000 
114 114 113 000 000 000 804 804 804 804 804 804 804 804 000 000 55
114 114 113 000 804 804 804 000 000 000 000 804 804 804 000 000 
114 114 113 000 804 804 804 000 000 000 000 804 804 804 000 000 
114 114 113 000 000 000 000 000 000 000 000 000 000 804 000 000 
114 114 113 000 000 000 000 000 000 000 000 000 000 804 000 000 
114 114 113 000 000 000 804 81d 000 000 000 804 804 804 000 000 60
114 114 113 c02 000 000 804 81d 000 000 000 804 804 804 000 000 
114 114 113 000 000 000 804 81d 000 000 000 804 804 804 000 000 
114 114 113 000 000 000 804 81d 000 000 000 804 804 804 000 000 
114 114 113 c01 000 000 804 804 804 804 804 804 804 804 000 000 
114 114 113 000 000 000 804 804 804 804 804 804 804 804 000 000 65
114 114 113 c01 000 000 000 000 000 000 000 000 000 804 000 000 
114 114 113 000 000 000 000 000 000 000 000 000 000 804 000 000 
114 114 113 000 000 000 000 000 000 000 000 804 804 804 000 000 
114 114 113 000 000 000 804 804 804 804 804 804 804 804 000 000 
114 114 113 000 000 000 804 81d 000 000 000 804 804 804 000 000 70
114 114 113 1d5 000 000 804 806 000 000 000 804 804 804 000 000 
114 114 113 1e5 000 000 000 000 000 000 000 000 000 804 000 000 
114 114 113 000 000 000 000 000 000 000 000 000 000 804 000 000 
114 114 113 000 000 000 804 804 804 804 804 000 000 804 000 000 
114 114 113 000 000 000 804 805 804 804 804 c01 000 804 000 000 75
114 114 113 000 000 000 000 000 000 000 000 000 000 804 000 000 
114 114 113 000 000 000 000 000 000 000 000 000 000 804 000 000 
114 114 113 000 000 000 804 c01 000 000 000 804 804 804 000 000 
114 114 113 000 000 000 804 c01 000 000 000 804 804 804 000 000 
114 114 113 000 000 000 804 000 000 000 000 804 804 804 000 000 80
124 124 123 000 000 000 804 000 000 000 000 804 804 804 000 000 
000 000 000 000 000 000 000 000 000 000 000 000 000 804 000 000 
000 000 000 000 000 000 000 000 000 000 000 000 000 804 000 000 
104 104 103 000 000 000 000 000 000 000 000 000 000 804 000 000 
114 114 113 000 000 000 000 804 804 000 81d 000 000 804 000 000 85
114 114 113 000 000 000 000 804 804 000 81d 000 000 804 000 000 
114 114 113 000 000 000 000 804 804 000 81d 000 000 804 000 000 
114 114 113 1f4 000 000 000 804 804 000 81d 000 000 804 000 000 
114 114 113 000 000 000 000 804 804 000 81d 000 000 804 000 000 
114 114 113 000 000 000 000 804 804 000 81d 000 000 808 000 000 90
114 114 113 000 000 000 000 000 000 000 000 000 000 804 000 000 
114 114 113 000 000 000 000 000 000 000 000 000 000 804 000 000 
114 114 113 000 000 000 000 000 000 000 000 000 000 804 000 000 
114 114 113 000 000 000 000 000 000 000 000 000 000 804 000 000 
114 114 113 000 000 000 000 000 000 000 000 000 000 804 000 000 95
114 114 113 000 000 000 000 000 000 000 000 000 000 804 000 000 
114 114 113 000 000 000 000 000 000 000 000 000 000 804 000 000 
114 114 113 000 000 000 000 000 000 000 000 000 000 804 000 000 
114 114 113 c01 000 000 000 000 000 000 000 000 000 804 000 000 
114 114 113 000 000 000 000 000 000 000 000 000 000 804 000 000 100
114 114 113 c01 000 000 000 000 000 000 000 000 000 804 000 000 
114 114 113 000 000 000 000 000 000 000 000 000 000 804 000 000 
114 114 113 c01 000 000 000 000 000 000 000 000 000 804 000 000 
114 114 113 002 002 81e c03 000 000 000 000 000 000 804 000 000 
114 114 113 012 012 81f 000 000 000 000 000 000 000 804 000 000 105
114 114 113 000 000 000 000 000 000 000 000 000 000 804 000 000 
114 114 113 000 000 000 000 000 000 000 000 000 000 804 000 000 
114 114 113 1f5 000 000 000 000 000 000 000 000 000 804 000 000 
114 114 113 000 000 000 000 000 000 000 000 000 000 804 000 000 
114 114 113 002 002 002 001 c03 000 000 000 000 000 804 000 000 110
114 114 113 012 012 012 011 000 000 000 000 000 000 804 000 000 
114 114 113 000 000 000 000 000 000 000 000 000 000 804 000 000 
114 114 113 000 000 000 000 000 000 000 000 000 000 804 000 000 
114 114 113 c01 000 000 000 000 000 000 000 000 000 804 000 000 
114 114 113 000 000 000 000 000 000 000 000 000 000 804 000 000 115
114 114 113 002 001 c03 000 000 000 000 000 000 000 804 000 000 
114 114 113 012 011 000 000 000 000 000 000 000 000 804 000 000 
114 114 113 000 000 000 000 000 000 000 000 000 000 804 000 000 
114 114 113 000 000 000 000 000 000 000 000 000 000 804 000 000 
124 124 123 000 000 000 000 000 000 000 000 000 000 804 000 000 120
000 000 000 000 000 000 000 000 000 000 000 000 000 804 000 000 
000 000 000 000 000 000 000 000 000 000 000 000 000 804 000 000 
104 104 103 804 804 804 000 000 000 000 000 000 000 804 000 000 
124 124 123 804 804 804 000 000 000 000 000 000 000 804 000 000 
000 000 000 000 000 000 000 000 000 000 000 000 000 804 000 000 125
000 000 000 000 000 000 000 000 000 000 000 000 000 804 000 000 
104 104 103 000 000 000 000 000 000 000 000 000 000 804 000 000 
114 114 113 000 000 000 000 000 000 000 000 000 000 804 000 000 
114 114 113 1d4 000 000 000 000 000 000 000 000 000 804 000 000 
114 114 113 1e4 000 000 000 000 000 000 000 000 000 804 000 000 130
114 114 113 000 000 000 000 000 000 000 000 000 000 804 000 000 
114 114 113 000 000 000 000 000 000 000 000 000 000 804 000 000 
114 114 113 000 000 000 000 000 000 000 000 000 000 804 000 000 
114 114 113 040 000 000 000 000 000 000 000 000 000 804 000 000 
114 114 113 040 040 000 000 000 000 000 000 000 000 804 000 000 135
114 114 113 040 040 040 c01 000 000 000 000 000 000 804 000 000 
114 114 113 040 040 040 040 000 000 000 000 000 000 804 000 000 
124 124 123 040 040 040 040 c01 000 000 000 000 000 804 000 000 
000 000 000 000 000 000 000 000 000 000 000 000 000 000 000 000 
000 000 000 000 000 000 000 000 000 000 000 000 000 000 000 000 140
000 000 000 000 000 000 000 000 000 000 000 000 000 000 000 000 
000 000 000 c00 000 000 000 000 000 c00 000 000 000 000 000 c00 
000 000 000 000 000 000 000 000 000 000 000 000 000 000 000 000 
000 000 000 000 000 000 000 000 000 000 000 000 000 000 000 000 
000 000 000 000 000 000 000 000 000 000 000 000 000 000 000 000 145
104 104 103 000 000 000 804 000 000 000 000 000 000 000 000 000 
114 114 113 c04 000 000 804 000 000 000 000 000 000 000 000 000 
114 114 113 000 000 000 804 000 000 000 000 000 000 000 000 000 
114 114 113 000 000 000 804 000 000 000 000 000 000 000 000 000 
114 114 113 000 000 000 804 000 000 000 000 000 000 000 000 000 150
114 114 113 000 000 000 806 000 000 000 000 000 000 000 000 000 
114 114 113 1d5 000 000 000 000 000 000 000 000 000 000 000 000 
124 124 123 1e5 000 000 000 000 000 000 000 000 000 000 000 000 
000 000 000 000 000 000 000 000 000 000 000 000 000 000 000 000 
000 000 000 000 000 000 000 000 000 000 000 000 000 000 000 000 155
000 000 000 000 000 000 000 000 000 000 000 000 000 000 000 000 
000 000 000 c00 000 000 000 000 000 c00 000 000 000 000 000 c00 
000 000 000 000 000 000 000 000 000 000 000 000 000 000 000 000 
000 000 000 000 000 000 000 000 000 000 000 000 000 000 000 000 
000 000 000 000 000 000 000 000 000 000 000 000 000 000 000 000 160
104 104 103 804 804 804 000 000 000 000 000 000 000 000 000 000 
114 114 113 804 804 804 000 000 000 000 000 000 000 105 104 104 
114 114 113 804 804 804 000 000 000 000 000 000 000 115 114 114 
114 114 113 804 804 804 000 000 000 000 000 000 000 115 114 114 
114 114 113 804 804 804 000 000 000 000 000 000 000 115 114 114 165
114 114 113 804 804 804 000 000 000 000 000 000 000 115 114 114 
114 114 113 804 804 804 823 021 000 000 000 000 000 115 114 114 
114 114 113 804 804 804 032 031 000 000 000 000 000 125 124 124 
114 114 113 804 804 804 082 081 002 002 002 002 002 002 002 002 
114 114 113 804 804 804 092 091 012 012 012 012 012 012 012 012 170
114 114 154 104 104 104 104 104 104 104 104 104 104 104 104 104 
114 114 114 114 114 114 114 114 114 114 114 114 114 114 114 114 
114 114 114 114 114 114 114 114 114 114 114 114 114 114 114 114 
114 114 114 114 114 114 114 114 114 114 114 114 114 114 114 114 