1
21
16
1
5568
288
0
0
0
0
0
0
114 114 114 114 114 114 114 114 114 114 114 114 114 114 114 114 
114 114 144 124 124 124 124 124 124 124 124 124 124 124 124 124 
114 114 113 000 000 000 000 000 000 000 000 000 000 001 002 002 
114 114 113 000 000 000 000 000 000 000 000 000 000 011 012 012 
114 114 113 000 000 000 804 000 000 000 804 804 804 804 105 104 5
114 114 113 81d 000 000 804 000 000 000 804 804 804 804 115 114 
114 114 113 81d 000 000 804 81d 000 000 804 804 804 804 115 114 
114 114 113 81d 000 000 804 81d 000 000 804 804 804 804 115 114 
114 114 113 81d 000 000 804 81d 000 000 804 804 804 804 115 114 
114 114 113 81d 000 000 804 81d 000 000 804 804 804 804 115 114 10
114 114 113 81d 000 000 804 81d 000 000 804 804 804 804 115 114 
114 114 113 81d 000 000 804 81d 000 000 804 804 804 804 115 114 
114 114 113 81d 000 000 804 81d 000 000 804 804 804 804 115 114 
114 114 113 81d 000 000 804 81d 000 000 804 804 804 804 115 114 
114 114 113 000 000 000 805 000 000 000 804 804 804 804 115 114 15
114 114 113 820 021 804 804 804 804 804 804 804 804 804 115 114 
114 114 113 032 031 804 804 804 804 804 804 804 804 804 115 114 
114 114 113 082 081 002 002 002 002 002 002 002 002 002 002 002 
114 114 113 092 091 012 012 012 012 012 012 012 012 012 012 012 
114 114 154 104 104 104 104 104 104 104 104 104 104 104 104 104 20
114 114 114 114 114 114 114 114 114 114 114 114 114 114 114 114 