0
35
16
0
0
0
0
0
0
0
0
0
111 110 000 000 000 000 000 000 000 000 000 000 000 000 000 000 
111 110 1f1 000 000 000 000 000 000 000 000 000 000 000 000 000 
111 110 000 000 000 000 000 000 000 000 000 000 000 000 000 000 
111 110 002 001 000 000 000 000 000 000 000 000 000 000 000 000 
111 110 012 011 000 000 000 000 000 000 000 000 000 000 000 000 5
111 110 040 000 000 000 000 000 000 000 000 000 000 000 000 000 
111 110 040 040 000 000 000 000 000 000 000 000 000 000 000 000 
111 110 040 040 040 000 000 000 000 000 000 000 000 000 000 000 
111 110 040 040 040 040 000 000 000 000 000 000 000 000 000 000 
111 110 040 040 040 040 040 000 000 000 000 000 000 000 000 000 10
111 110 040 040 040 040 040 040 000 000 000 000 000 000 000 000 
111 110 040 040 040 040 040 040 040 000 000 000 000 000 000 000 
111 110 040 040 040 040 040 040 040 040 000 000 000 000 000 000 
111 110 040 040 040 040 040 040 040 040 000 000 000 000 000 000 
111 110 000 000 000 000 000 000 000 000 000 000 000 000 000 000 15
111 110 1d0 000 000 000 000 000 000 000 000 000 000 000 000 000 
111 110 1e0 000 000 000 000 000 000 000 000 000 000 000 000 000 
111 110 1f0 000 000 000 000 000 000 000 000 000 000 000 000 000 
111 110 000 000 000 000 000 000 000 000 000 000 000 000 000 000 
111 110 000 000 000 000 000 000 000 000 000 000 000 000 000 000 20
111 110 000 000 000 000 000 000 000 000 000 000 000 000 000 000 
111 110 000 000 000 000 000 000 000 000 000 000 000 000 000 000 
111 110 0a4 81c 81c 81c 81c 81c 81c 81c 81c 81b 81a 000 000 000 
111 110 000 000 000 000 000 000 000 000 000 0b1 0b0 006 006 006 
111 110 000 000 000 000 000 000 000 000 000 000 000 000 000 000 25
111 110 000 000 000 000 000 000 000 000 000 000 000 000 000 000 
111 110 000 000 000 000 000 000 000 000 000 000 000 000 000 000 
111 110 000 000 000 000 000 000 000 000 000 000 000 000 000 000 
111 110 0b4 0b3 0b2 000 000 000 000 000 000 000 000 000 000 000 
111 110 0c4 0c3 0c2 0c1 0c0 000 000 000 000 000 000 000 000 000 30
111 110 0d4 0d3 0d2 0d1 0d0 000 000 000 000 000 000 000 000 000 
111 110 0e4 0e3 0e2 0e1 0e0 000 000 000 000 000 000 000 000 000 
111 110 0f4 0f3 0f2 000 000 000 000 000 000 000 000 000 000 000 
111 110 000 000 000 000 000 000 000 000 000 000 000 000 000 000 
111 110 000 000 000 000 000 000 000 000 000 000 000 000 000 000 35 