6
66
16
1
144
528
0
0
0
0
0
0
311 310 000 000 000 000 000 000 000 000 000 000 000 000 000 000
311 310 000 000 000 000 000 000 000 000 000 000 000 000 000 000
311 310 1e8 1e7 000 000 000 000 000 000 000 000 000 000 000 000
311 310 1f8 1f7 000 000 000 000 000 000 000 000 000 000 000 000
311 310 000 000 000 000 000 000 000 000 000 000 000 000 000 000 5
311 310 000 000 000 000 000 000 000 000 000 000 000 000 000 000
311 269 268 000 000 000 000 000 000 000 000 000 000 000 000 000
311 311 269 268 000 000 000 000 000 000 000 000 000 000 000 000
311 311 311 269 268 000 000 000 000 000 000 000 000 000 000 000
311 311 311 311 269 268 000 000 000 000 000 000 000 000 000 000 10
311 311 311 311 311 269 268 000 000 000 000 000 000 000 000 000
311 311 311 311 311 311 269 268 000 000 000 000 000 000 000 000
311 341 321 321 321 321 381 269 268 000 000 000 000 000 000 000
311 310 000 000 000 000 312 311 310 000 000 000 000 000 000 000
311 310 3d2 3d1 000 000 312 311 310 000 000 000 000 000 000 000 15
311 310 000 000 000 000 312 311 310 000 000 000 804 000 000 000
311 310 000 000 000 000 312 311 310 000 000 000 800 000 000 000
311 310 3d2 3d1 000 000 312 311 310 000 000 000 801 000 000 000
311 310 000 000 000 000 312 311 310 000 000 000 804 000 000 000
311 310 000 000 000 000 312 311 310 000 000 000 000 000 000 000 20
311 110 3f0 000 000 000 312 311 310 000 000 000 000 000 000 000
311 110 000 000 000 000 312 311 310 000 000 000 000 000 000 000
311 110 1da 1d9 000 000 312 311 310 000 000 000 000 000 000 000
311 110 000 000 000 000 312 311 310 000 000 000 000 000 000 000
311 110 000 000 000 000 312 311 310 000 000 000 000 000 000 000 25
311 310 000 000 000 000 312 311 310 000 000 000 000 000 000 000
311 310 002 002 002 002 312 311 310 002 81e 000 000 000 000 000
311 310 012 012 012 012 312 311 310 012 81f 000 000 000 000 000
311 310 000 000 000 000 312 311 310 000 000 000 000 000 000 000
311 310 000 000 000 000 312 311 351 301 301 301 301 301 301 301 30
311 310 000 000 000 000 322 321 321 321 321 321 321 321 321 321
311 310 002 001 000 000 000 000 000 000 000 000 000 000 000 000
311 310 012 011 000 000 000 000 000 000 000 000 000 000 000 000
311 310 000 000 000 000 000 000 000 000 000 000 000 000 000 000
311 310 000 000 000 000 000 000 000 000 000 000 000 000 000 000 35
311 310 040 000 000 000 000 000 000 000 000 000 000 000 000 000
311 310 040 040 000 000 000 000 000 000 000 000 000 000 000 000
321 320 040 040 040 000 000 000 000 000 000 000 000 000 000 000
000 000 000 000 818 000 000 000 000 000 000 000 000 000 000 000
000 000 000 000 818 000 000 000 000 000 000 000 000 000 000 000 40
000 000 000 000 000 000 000 000 000 000 000 000 000 000 000 000
000 000 000 000 000 000 000 000 000 000 000 000 000 000 000 000
000 000 000 000 000 000 000 000 000 000 000 000 000 000 000 000
301 300 040 040 040 040 040 040 040 040 000 000 000 000 000 000
311 310 040 040 040 040 040 040 040 040 000 000 000 000 000 000 45
311 310 000 000 000 000 000 000 000 000 000 000 000 000 000 000
311 310 000 000 000 000 000 000 000 000 000 000 000 000 000 000
311 310 000 000 000 000 000 000 000 000 000 000 000 000 000 000
311 310 000 000 000 000 000 000 000 000 000 000 000 000 000 000
311 310 000 000 000 000 000 000 000 000 000 000 000 000 000 000 50
311 310 000 000 000 000 000 000 000 000 000 000 000 000 000 000
311 310 000 000 000 000 000 000 000 000 000 000 000 000 000 000
311 310 000 000 000 000 000 000 000 000 000 000 000 000 000 000
311 310 0a4 81c 81c 81c 81c 81c 81c 81c 81c 81b 81a 000 000 000
311 310 000 000 000 000 000 000 000 000 000 0b1 0b0 006 006 006 55
311 310 000 000 000 000 000 000 000 000 000 000 000 000 000 000
311 310 3d0 000 000 000 000 000 000 000 000 000 000 000 000 000
311 310 3e0 000 000 000 000 000 000 000 000 000 000 000 000 000
311 310 000 000 000 000 000 000 000 000 000 000 000 000 000 000
311 310 0b4 0b3 0b2 000 000 000 000 000 000 000 000 000 000 000 60
311 310 0c4 0c3 0c2 0c1 0c0 000 000 000 000 000 000 000 000 000
311 310 0d4 0d3 0d2 0d1 0d0 000 000 000 000 000 000 000 000 000
311 310 0e4 0e3 0e2 0e1 0e0 000 000 000 000 000 000 000 000 000
311 310 0f4 0f3 0f2 000 000 000 000 000 000 000 000 000 000 000
311 310 000 000 000 000 000 000 000 000 000 000 000 000 000 000 65
311 310 000 000 000 000 000 000 000 000 000 000 000 000 000 000