1
179
16
0
1536
240
0
0
0
0
0
0
114 114 114 114 114 114 114 114 114 114 114 114 114 114 114 114
114 144 124 124 124 124 124 124 124 124 124 124 124 124 124 124
114 113 000 000 000 000 000 000 000 000 000 000 001 002 002 002
114 113 000 000 000 000 000 000 000 000 000 000 011 012 012 012
114 113 000 000 000 105 104 104 104 104 104 104 104 104 104 104 5
114 113 000 000 000 115 114 114 114 114 114 114 114 114 114 114
114 113 000 000 000 115 114 114 114 114 114 114 114 114 114 114
114 113 1d5 000 000 125 124 124 124 124 124 124 124 124 124 124
114 113 1e5 000 000 000 000 000 000 000 000 000 000 000 000 000
114 113 000 000 000 000 000 000 000 000 000 000 000 000 000 000 10
114 113 000 000 000 000 000 000 000 000 000 000 000 000 000 000
114 113 000 000 000 000 000 000 000 000 000 000 000 000 000 000
114 113 000 000 000 000 000 000 000 000 000 000 000 000 000 000
114 154 104 104 103 c01 000 000 000 000 000 000 000 000 000 000
114 114 114 114 113 000 000 000 000 000 000 000 000 000 000 000 15
114 114 114 114 113 c01 000 000 000 000 000 000 000 000 000 000
114 144 124 124 123 000 000 000 000 000 000 000 000 000 000 000
114 113 000 000 000 000 000 000 000 000 000 000 000 000 000 000
114 113 000 000 000 000 000 000 000 000 000 000 000 000 000 000
114 113 000 000 000 000 000 000 000 000 000 000 000 000 000 000 20
114 113 000 000 000 814 000 000 000 000 000 000 000 000 000 000
114 113 000 000 000 814 000 000 000 000 000 000 000 000 000 000
114 113 1d4 000 000 814 000 000 000 000 000 000 000 000 000 000
114 113 1e4 000 000 814 000 000 000 000 000 000 000 000 000 000
114 113 1f4 000 000 000 000 000 000 000 000 000 000 000 000 000 25
114 113 000 000 000 000 000 000 000 000 000 000 000 000 000 000
114 154 104 104 104 104 104 103 000 000 000 000 000 000 000 000
114 114 114 114 114 114 114 113 000 000 000 000 000 000 000 000
114 114 114 114 114 114 114 113 000 000 000 000 000 000 000 000
114 114 114 114 114 114 271 270 000 000 000 000 000 000 000 000 30
114 114 114 114 114 271 270 000 000 000 000 000 000 000 000 000
114 114 114 114 271 270 000 000 000 000 000 000 000 000 000 000
114 114 114 114 2a0 000 000 81d 000 000 000 000 000 000 000 000
114 114 114 2b1 2b0 000 000 81d 000 000 000 000 000 000 000 000
114 114 114 2a0 c02 000 000 000 000 000 000 000 000 000 000 000 35
114 114 2b1 2b0 000 000 000 000 000 000 000 000 000 000 000 000
114 114 2a0 000 000 000 000 000 000 000 000 000 000 000 000 000
114 2b1 2b0 c02 000 000 000 000 000 000 000 000 000 000 000 000
114 113 000 000 000 000 000 000 000 000 000 000 000 000 000 000
114 113 c01 000 000 000 000 000 000 000 000 000 000 000 000 000 40
114 113 000 000 000 000 000 000 000 000 000 000 000 000 000 000
114 113 040 040 040 000 000 000 000 000 000 000 000 000 000 000
114 113 80f 000 000 000 000 000 000 000 000 000 000 000 000 000
114 113 80f 000 000 000 000 000 000 000 000 000 000 000 000 000
114 113 80f 000 000 000 000 000 000 000 000 000 000 000 000 000 45
114 113 80f 000 000 000 814 000 000 000 000 000 000 000 000 000
114 113 80f 000 000 000 814 000 000 000 000 000 000 000 000 000
114 113 80f 000 000 000 814 000 000 000 000 000 000 000 000 000
114 113 80f 000 000 000 814 000 000 000 000 000 000 000 000 000
114 113 80f 000 000 000 814 000 000 000 000 000 000 000 000 000 50
114 113 80f 000 000 000 000 000 000 000 000 000 000 000 000 000
114 113 80f 000 000 000 000 000 000 000 000 000 000 000 000 000
114 113 040 040 040 000 000 000 000 000 000 000 000 000 000 000
114 113 040 040 040 1f4 000 000 000 000 000 000 000 000 000 000
114 113 040 040 040 000 000 000 000 000 000 000 000 000 000 000 55
114 113 80f 000 000 000 000 000 000 000 000 000 000 000 000 000
114 113 80f 000 000 000 000 000 000 000 000 000 000 000 000 000
114 113 80f 000 000 000 000 000 000 000 000 000 000 000 000 000
114 113 80f 000 000 000 000 000 000 000 000 000 000 000 000 000
114 113 80f 000 815 000 000 000 000 000 000 000 000 000 000 000 60
114 113 80f 000 815 000 000 000 000 000 000 000 000 000 000 000
114 113 80f 000 815 000 000 000 000 000 000 000 000 000 000 000
114 113 80f 000 815 000 000 000 000 000 000 000 000 000 000 000
114 113 80f 000 815 000 000 000 000 000 000 000 000 000 000 000
114 113 80f 000 815 000 000 000 000 000 000 000 000 000 000 000 65
114 113 80f 000 815 000 000 000 000 000 000 000 000 000 000 000
114 113 80f 000 815 000 000 000 000 000 000 000 000 000 000 000
114 113 80f 000 815 000 000 000 000 000 000 000 000 000 000 000
114 113 80f 000 815 c01 000 000 000 000 000 000 000 000 000 000
114 113 80f 000 815 000 000 000 000 000 000 000 000 000 000 000 70
114 113 80f 000 815 c01 000 000 000 000 000 000 000 000 000 000
114 113 80f 000 000 000 000 000 000 000 000 000 000 000 000 000
114 113 80f 000 000 000 000 000 000 000 000 000 000 000 000 000
114 113 002 002 002 002 002 001 c03 000 000 000 000 000 000 000
114 113 012 012 012 012 012 011 000 000 000 000 000 000 000 000 75
114 113 000 000 000 000 000 000 000 000 000 000 000 000 000 000
114 113 1f5 000 000 000 000 000 000 000 000 000 000 000 000 000
124 123 000 000 000 000 000 000 000 000 000 000 000 000 000 000
000 000 000 000 000 804 000 000 000 000 000 000 000 000 000 000
000 000 000 000 000 805 002 002 001 c03 000 000 000 000 000 000 80
000 000 000 000 000 805 012 012 011 000 000 000 000 000 000 000
000 000 000 000 000 804 000 000 000 000 000 000 000 000 000 000
104 103 000 000 000 000 000 000 000 000 000 000 000 000 000 000
114 113 002 002 001 c03 000 000 000 000 000 000 000 000 000 000
124 123 012 012 011 000 000 000 000 000 000 000 000 000 000 000 85
000 000 000 000 000 000 000 000 000 000 000 000 000 000 000 000
000 000 000 000 000 000 000 000 000 000 000 000 000 000 000 000
000 000 000 000 000 000 000 000 000 000 000 000 000 000 000 000
104 103 002 001 c03 000 000 000 000 000 000 000 000 000 000 000
124 123 012 011 000 000 000 000 000 000 000 000 000 000 000 000
000 000 000 000 000 000 000 000 000 000 000 000 000 000 000 000 90
000 000 000 000 000 000 000 000 000 000 000 000 000 000 000 000
104 103 002 002 002 002 001 c03 000 000 000 000 000 000 000 000
124 123 012 012 012 012 011 000 000 000 000 000 000 000 000 000
000 000 000 000 000 000 000 000 000 000 000 000 000 000 000 000
000 000 000 000 000 000 000 000 000 000 000 000 000 000 000 000 95
104 103 002 002 001 c03 000 000 000 000 000 000 000 000 000 000
124 123 012 012 011 000 000 000 000 000 000 000 000 000 000 000
000 000 000 000 000 000 000 000 000 000 000 000 000 000 000 000
000 000 000 000 000 000 000 000 000 000 000 000 000 000 000 000
104 103 000 000 000 000 000 000 000 000 000 000 000 000 000 001 100
114 113 000 000 000 000 000 000 000 000 000 000 000 000 000 000
114 113 000 000 000 000 000 000 000 000 000 000 000 000 000 000
114 113 000 000 000 000 000 000 000 000 000 000 000 000 000 000
114 113 040 040 040 040 000 000 000 000 000 000 000 000 000 000
114 113 80f 000 000 000 000 000 000 000 000 000 000 000 000 000 105
114 113 80f 000 815 000 000 000 000 000 000 000 000 000 000 000
114 113 80f 000 815 000 000 000 000 000 000 000 000 000 000 000
114 113 80f 000 815 000 000 811 105 104 104 104 104 104 104 104
124 123 80f 000 815 000 000 811 115 114 114 114 114 114 114 114
000 000 000 000 815 000 000 811 115 114 114 114 114 114 114 114 110
000 000 000 000 815 000 000 811 125 124 124 124 124 124 124 124
000 000 000 000 815 000 000 000 000 000 000 000 000 000 000 000
000 000 000 000 815 000 000 000 000 000 000 000 000 000 000 000
000 000 000 000 000 000 000 000 000 000 000 000 000 000 000 000
134 134 134 133 008 c0d 040 000 000 000 000 000 000 000 000 000 115
000 000 000 000 000 040 c0d 000 000 000 000 000 000 000 000 000
000 000 000 000 000 000 000 000 000 000 000 000 000 000 000 000
000 000 000 000 000 000 000 000 000 000 000 000 000 000 000 000
000 000 000 000 814 000 000 000 000 000 000 000 000 000 000 000
000 000 000 000 000 000 000 000 000 000 000 000 000 000 000 000 120
000 000 000 000 000 000 000 000 000 000 000 000 000 000 000 000
000 000 000 000 000 000 000 000 000 000 000 000 000 000 000 000
000 000 000 000 814 000 000 000 000 000 000 000 000 000 000 000
000 000 000 000 000 000 000 000 000 000 000 000 000 000 000 000
000 000 000 000 000 000 000 000 000 000 000 000 000 000 000 000 125
000 000 000 000 000 000 000 000 000 000 000 000 000 000 000 000
104 104 164 134 134 133 000 000 000 000 000 000 000 000 000 000
114 114 113 000 000 000 000 000 000 000 000 000 000 000 000 000
114 114 113 1d3 000 000 000 000 000 000 000 000 000 000 000 000
114 114 113 1e3 000 817 000 000 000 000 000 000 000 000 000 000 130
124 124 123 1f3 000 817 81d 000 000 000 000 000 000 000 000 000
000 000 000 000 000 817 81d 000 000 000 000 000 000 000 000 000
000 000 000 000 000 817 81d 000 000 000 000 000 000 000 000 000
000 000 000 000 000 817 000 000 000 000 000 000 000 000 000 000
000 000 000 000 000 000 000 000 000 000 000 000 000 000 000 000 135
104 104 103 1a4 1a4 1a4 1a4 1a3 000 000 000 000 000 000 000 000
114 114 113 1b4 1b4 1b4 1b4 1b3 000 000 000 000 000 000 000 000
114 114 113 1b4 1b4 1b4 1b4 1b3 000 000 000 000 000 000 000 000
124 124 123 1c4 1c4 1c4 1c4 1c3 c01 000 000 000 000 000 000 000
000 000 000 000 000 000 000 000 000 000 000 000 000 000 000 000 140
000 000 000 000 000 000 000 c07 000 000 000 000 000 000 000 000
000 000 000 000 000 000 000 000 000 000 000 000 000 000 000 000
000 000 000 000 000 000 816 000 000 000 000 000 000 000 000 000
000 000 000 000 000 000 816 000 000 000 000 000 000 000 000 000
000 000 000 000 000 000 816 000 000 000 000 000 000 000 000 000 145
000 000 000 000 000 000 000 000 000 000 000 000 000 000 000 000
000 000 000 000 000 000 000 c07 000 000 000 000 000 000 000 000
000 000 000 000 000 000 000 000 000 000 000 000 000 000 000 000
000 000 000 000 000 000 817 000 000 000 000 000 000 000 000 000
000 000 000 000 000 000 817 000 000 000 000 000 000 000 000 000 150
000 000 000 000 000 000 817 000 000 000 000 000 000 000 000 000
000 000 000 000 000 000 000 000 000 000 000 000 000 000 000 000
000 000 000 000 000 000 000 000 000 000 000 000 000 000 000 000
000 000 000 000 815 000 000 000 000 000 000 000 000 000 000 000
000 000 000 000 815 000 000 000 000 000 000 000 000 000 000 000 155
000 000 000 000 815 000 000 000 000 000 000 000 000 000 000 000
000 000 000 000 815 813 813 000 000 000 000 000 000 000 000 000
000 000 000 000 815 000 000 000 000 000 000 000 000 000 000 000
000 000 000 000 815 000 000 000 000 000 000 000 000 000 000 000
000 000 000 000 815 000 000 000 000 000 000 000 000 000 000 000 160
000 000 000 000 815 000 000 813 000 000 000 000 000 000 000 000
000 000 000 000 815 000 000 000 000 000 000 000 000 000 000 000
000 000 000 000 815 000 000 000 000 000 000 000 000 000 000 000
000 000 000 000 000 000 000 000 000 000 000 000 000 000 000 000
000 000 000 000 000 000 000 000 000 000 000 000 000 000 000 000 165
000 000 000 000 000 000 815 000 000 000 000 000 000 000 000 000
000 000 000 000 000 000 815 000 000 000 000 000 000 000 000 000
000 000 000 000 000 000 815 000 000 000 000 000 000 000 000 000
000 000 000 000 000 000 815 000 000 000 000 000 000 000 000 000
000 000 000 000 000 000 815 000 000 000 000 000 000 000 000 000 170
000 000 000 000 000 000 815 000 000 000 000 000 000 000 000 000
000 000 000 000 000 000 815 000 000 000 000 000 000 000 105 104
000 000 000 000 000 000 815 000 c06 000 81e 002 002 002 115 114
000 000 000 000 000 000 815 000 000 000 81f 012 012 012 115 114
000 000 000 000 000 000 815 c06 000 000 000 000 000 000 115 114 175
000 000 000 000 000 000 000 000 000 000 000 000 000 000 115 114
104 104 104 104 104 104 104 104 104 104 104 104 104 104 194 114
114 114 114 114 114 114 114 114 114 114 114 114 114 114 114 114
114 114 114 114 114 114 114 114 114 114 114 114 114 114 114 114