6
212
16
0
0
0
0
0
0
0
0
0
311 310 000 000 000 000 000 000 000 000 000 000 000 000 000 000 
311 310 000 000 000 000 000 000 000 000 000 000 000 000 000 000 
311 310 000 000 000 000 000 000 000 000 000 000 000 000 000 000 
311 310 000 000 000 000 000 000 000 000 000 000 000 000 000 000 
311 310 1e8 1e7 000 000 000 000 000 000 000 000 000 000 000 000 5
311 310 1f8 1f7 000 000 000 000 000 000 000 000 000 000 000 000 
311 310 000 000 000 000 000 000 000 000 000 000 000 000 000 000 
311 310 000 000 000 000 000 000 000 000 000 000 000 000 000 000 
311 310 000 1cf 19f 000 000 000 000 000 000 000 000 000 000 000 
311 310 1fe 1df 1af 000 000 000 000 000 000 000 000 000 000 000 10
311 310 000 1ef 1bf 000 000 000 000 000 000 000 000 000 000 000 
311 310 000 000 000 000 000 000 000 000 000 000 000 000 000 000 
311 310 040 000 000 000 000 000 000 000 000 000 000 000 000 000 
311 310 040 040 000 000 000 000 000 000 000 000 000 000 000 000 
311 310 040 040 040 000 000 000 000 000 000 000 000 000 000 000 15
311 310 040 040 040 040 000 000 000 000 000 000 000 000 000 000 
311 310 000 000 000 040 000 000 000 000 000 000 000 000 000 000 
311 310 000 000 000 040 008 c0d 000 000 000 000 000 000 000 000 
311 310 000 000 000 000 000 000 000 000 000 000 000 000 000 000 
311 310 000 000 000 000 000 000 000 000 000 000 000 000 000 000 20
311 310 3d2 3d1 000 000 000 000 000 000 81d 000 000 000 000 000 
311 310 000 000 000 000 000 000 000 000 81d 000 000 000 000 000 
311 310 c02 000 000 000 000 000 000 000 81d 000 000 000 000 000 
311 310 000 000 000 000 000 000 000 000 000 000 000 000 000 000 
321 320 819 000 000 000 000 000 000 000 000 000 000 000 000 000 25
000 000 000 000 000 000 000 000 000 000 000 000 000 000 000 000 
000 000 000 000 000 000 000 000 000 000 000 000 000 000 000 000 
000 000 000 000 000 000 000 000 000 000 000 000 000 000 000 000 
301 300 000 000 000 804 81d 000 000 804 000 000 000 000 000 000 
311 310 000 000 000 804 81d 000 000 804 000 000 000 000 000 000 30
311 310 000 000 000 804 81d 000 000 804 000 000 000 000 000 000 
311 310 000 000 000 804 000 000 000 804 000 000 000 000 000 000 
311 310 000 000 000 804 000 000 000 804 000 000 000 000 000 000 
311 310 000 000 000 804 000 000 000 806 000 000 000 000 000 000 
311 310 3e1 000 000 000 000 000 000 000 000 000 000 000 000 000 35
311 310 000 000 000 000 000 000 000 000 000 000 000 000 000 000 
311 310 000 000 000 000 000 000 000 000 000 000 000 000 000 000 
311 310 000 000 000 000 000 000 000 000 000 000 000 000 000 000 
311 310 000 000 000 000 000 000 000 000 000 000 000 000 000 000 
311 310 000 000 000 c06 000 000 000 000 000 000 000 000 000 000 40
311 310 000 000 000 000 000 000 000 000 000 000 000 000 000 000 
311 310 000 000 000 000 000 000 000 000 000 000 000 000 000 000 
311 310 000 000 000 000 000 000 000 000 000 000 000 000 000 000 
311 310 040 000 000 000 000 000 000 000 000 000 000 000 000 000 
311 310 040 040 000 000 000 000 000 000 000 000 000 000 000 000 45
311 310 040 040 040 c0b 000 000 000 000 000 000 000 000 000 000 
311 310 040 040 040 040 000 000 000 000 000 000 000 000 000 000 
311 310 040 040 040 040 000 000 000 000 000 000 000 000 000 000 
311 310 040 040 000 000 000 000 000 000 000 000 000 000 000 000 
311 310 000 000 000 000 000 000 000 000 000 000 000 000 000 000 50
311 310 000 000 000 000 000 000 000 000 000 000 000 000 000 000 
311 310 000 000 000 000 000 000 000 000 000 000 000 000 000 000 
311 310 000 000 000 000 000 000 000 000 000 000 000 000 000 000 
311 310 000 000 000 000 000 000 000 000 000 000 000 000 000 000 
311 310 002 002 001 c03 000 000 000 000 000 000 000 000 000 000 55
311 310 012 012 011 000 000 000 000 000 000 000 000 000 000 000 
311 310 000 000 000 000 000 000 000 000 000 000 000 000 000 000 
311 310 000 000 000 000 000 000 000 000 000 000 000 000 000 000 
311 310 3d0 000 000 000 000 000 000 000 000 000 000 000 000 000 
311 310 3e0 000 000 000 000 000 000 000 000 000 000 000 000 000 60
311 310 000 000 000 000 000 000 000 000 000 000 000 000 000 000 
311 310 040 000 000 000 000 000 000 000 000 000 000 000 000 000 
311 310 040 040 000 000 000 000 000 000 000 000 000 000 000 000 
311 310 040 040 040 000 000 000 000 000 000 000 000 000 000 000 
321 320 040 040 040 040 000 000 000 000 000 000 000 000 000 000 65
000 000 000 000 000 000 000 000 000 000 000 000 000 000 000 000 
000 000 000 000 000 000 000 000 000 000 000 000 000 000 000 000 
301 300 040 040 040 040 040 000 000 000 000 000 000 000 000 000 
311 310 040 040 040 040 040 040 000 000 000 000 000 000 000 000 
311 310 040 040 040 040 040 040 000 000 000 000 000 000 000 000 70
311 310 000 000 000 000 000 000 000 000 000 000 000 000 000 000 
311 310 000 000 000 000 000 000 000 000 000 000 000 000 000 000 
311 310 000 000 000 000 000 000 000 000 000 000 000 000 000 000 
311 310 000 000 000 000 000 000 000 000 000 000 000 000 000 000 
311 310 000 000 000 000 000 000 000 000 000 000 000 000 000 000 75
311 310 000 000 000 000 000 000 000 000 000 000 000 000 000 000 
311 310 3f0 000 000 000 000 000 000 000 000 000 000 000 000 000 
311 310 000 000 000 800 000 000 000 000 000 000 000 000 000 000 
311 310 000 000 000 800 000 000 000 000 000 000 000 000 000 000 
311 310 000 000 000 800 000 000 000 000 000 000 000 000 000 000 80
311 310 000 000 000 800 c0b 000 000 000 000 000 000 000 000 000 
311 310 000 000 000 800 000 000 000 000 000 000 000 000 000 000 
311 310 000 000 000 000 000 000 000 000 000 000 000 000 000 000 
311 310 000 000 000 80a 000 000 000 000 000 000 000 000 000 000 
311 310 000 000 000 000 000 000 000 804 000 000 000 000 000 000 85
311 310 000 000 000 000 000 000 000 804 81d 000 000 000 000 000 
311 310 000 000 000 000 000 000 000 804 81d 000 000 000 000 000 
311 310 000 000 000 000 000 000 000 000 000 000 000 000 000 000 
311 310 81d 000 000 000 804 000 000 000 000 000 000 000 000 000 
311 310 81d 000 000 000 804 000 000 000 000 000 000 000 000 000 90
321 320 000 000 000 000 804 000 000 000 000 000 000 000 000 000 
000 000 000 000 000 000 000 000 000 000 000 000 000 000 000 000 
000 000 000 000 000 000 000 000 000 000 000 000 000 000 000 000 
000 000 000 000 000 000 000 000 000 000 000 000 000 000 000 000 
000 000 000 000 000 000 000 000 000 000 000 000 000 000 000 000 95
301 300 000 000 000 000 000 000 000 000 000 000 000 000 000 000 
311 310 000 000 000 000 000 000 000 000 000 000 000 000 000 000 
311 310 000 000 000 000 000 000 000 000 000 000 000 000 000 000 
311 310 000 000 000 000 000 000 000 000 000 000 000 000 000 000 
311 310 000 000 000 000 000 000 000 000 000 000 000 000 000 000 100
311 310 3e2 000 000 000 000 000 000 000 000 000 000 000 000 000 
311 310 3f2 000 000 000 000 000 000 000 000 000 000 000 000 000 
311 310 000 000 000 000 000 000 000 000 000 000 000 000 000 000 
311 310 000 000 000 000 000 000 000 000 000 000 000 000 000 000 
311 310 000 000 000 000 000 000 000 000 000 000 000 000 000 000 105
311 310 000 000 000 c06 000 000 000 000 000 000 000 000 000 000 
311 310 008 c0d 000 000 000 000 000 000 000 000 000 000 000 000 
311 310 000 000 000 000 000 000 000 000 000 000 000 000 000 000 
311 310 000 000 000 000 000 000 000 000 000 000 000 000 000 000 
311 310 000 000 000 000 000 000 000 000 000 000 000 000 000 000 110
311 310 000 000 000 000 000 000 000 000 000 000 000 000 000 000 
311 310 3f1 000 000 000 000 000 000 000 000 000 000 000 000 000 
311 310 000 000 000 000 000 000 000 000 000 000 000 000 000 000 
311 310 000 000 000 000 000 000 000 000 000 000 000 000 000 000 
311 310 002 001 c03 000 000 000 000 000 000 000 000 000 000 000 115
311 310 012 011 000 000 000 000 000 000 000 000 000 000 000 000 
311 310 000 000 000 000 000 000 000 000 000 000 000 000 000 000 
311 310 000 000 000 804 000 000 000 804 000 000 000 000 000 000 
311 310 000 000 000 804 000 000 000 804 000 000 000 000 000 000 
311 310 000 000 000 804 c0b 000 000 804 000 000 000 000 000 000 120
311 310 000 000 000 804 000 000 000 804 000 000 000 000 000 000 
311 310 3e1 000 000 804 000 000 000 804 000 000 000 000 000 000 
311 310 000 000 000 804 000 000 000 804 000 000 000 000 000 000 
311 310 000 000 000 804 000 000 000 804 c0b 000 000 000 000 000 
311 310 000 000 000 804 000 000 000 807 000 000 000 000 000 000 125
321 320 000 000 000 000 000 000 000 000 000 000 000 000 000 000 
000 000 000 000 000 000 000 000 000 000 000 000 000 000 000 000 
000 000 000 000 000 000 000 000 000 000 000 000 000 000 000 000 
301 300 040 040 040 000 000 000 000 000 000 000 000 000 000 000 
311 310 000 000 000 000 000 000 000 000 000 000 000 000 000 000 130
311 310 000 000 000 000 000 000 000 000 000 000 000 000 000 000 
311 310 000 000 000 000 000 000 000 000 000 000 000 000 000 000 
311 310 000 000 000 000 000 000 000 000 000 000 000 000 000 000 
311 310 000 000 000 000 000 000 000 000 000 000 000 000 000 000 
311 310 000 000 000 000 000 000 000 000 000 000 000 000 000 000 135
311 310 c0c 000 000 000 000 000 000 000 000 000 000 000 000 000 
311 310 c0c 000 000 000 000 000 000 000 000 000 000 000 000 000 
311 310 c0c 000 000 000 000 000 000 000 000 000 000 000 000 000 
311 310 000 000 000 000 000 000 000 000 000 000 000 000 000 000 
311 310 000 000 000 000 000 000 000 000 000 000 000 000 000 000 140
311 310 000 805 000 000 000 000 000 000 000 000 000 000 000 000 
311 310 000 806 000 000 000 000 000 000 000 000 000 000 000 000 
321 320 000 000 000 000 000 000 000 000 000 000 000 000 000 000 
000 000 000 000 000 000 000 000 000 000 000 000 000 000 000 000 
000 000 000 000 000 000 000 000 000 000 000 000 000 000 000 000 145
000 000 000 000 000 000 000 000 000 000 000 000 000 000 000 000 
000 000 000 000 000 804 000 000 000 000 000 000 000 000 000 000 
000 000 000 000 000 804 000 000 000 000 000 000 000 000 000 000 
000 000 000 000 000 804 000 000 000 000 000 000 000 000 000 000 
000 000 000 000 000 000 000 000 000 000 000 000 000 000 000 000 150
301 300 000 000 000 000 000 000 000 000 000 000 000 000 000 000 
311 310 000 000 000 000 000 000 000 000 000 000 000 000 000 000 
311 310 000 000 000 000 000 000 000 804 000 000 000 000 000 000 
311 310 000 000 000 000 000 000 000 804 000 000 000 000 000 000 
311 310 c01 000 000 000 000 000 000 804 000 000 000 000 000 000 155
311 310 000 000 000 000 000 000 000 804 000 000 000 000 000 000 
311 310 c01 000 000 000 000 000 000 804 c04 000 000 000 000 000 
311 310 000 000 000 000 000 000 000 000 000 000 000 000 000 000 
311 310 3d2 3d1 000 000 000 000 000 000 000 000 000 000 000 000 
311 310 000 000 000 000 000 000 000 000 000 000 000 000 000 000 160
311 310 000 000 000 000 000 000 000 000 000 000 000 000 000 000 
311 310 000 000 000 000 000 000 000 000 000 000 000 000 000 000 
311 310 000 000 c06 000 000 000 000 000 000 000 000 000 000 000 
311 310 000 000 000 000 000 000 000 000 000 000 000 000 000 000 
311 310 000 000 000 000 000 000 000 000 000 000 000 000 000 000 165
311 310 000 c06 000 000 000 000 000 000 000 000 000 000 000 000 
311 310 000 000 000 000 000 000 000 000 000 000 000 000 000 000 
311 310 000 000 000 806 000 000 000 000 000 000 000 000 000 000 
321 320 000 000 000 000 000 000 000 000 000 000 000 000 000 000 
000 000 000 000 000 000 000 000 000 000 000 000 000 000 000 000 170
000 000 000 000 000 000 000 000 000 000 000 000 000 000 000 000 
000 000 000 000 000 000 000 000 000 804 81d 000 000 000 000 000 
301 300 002 001 000 000 000 000 000 804 81d 000 000 000 000 000 
321 320 012 011 000 000 000 000 000 804 000 000 000 000 000 000 
000 000 000 000 000 000 000 000 000 804 000 000 000 000 000 000 175
000 000 000 000 000 000 000 000 000 000 000 000 000 000 000 000 
301 300 000 000 000 000 000 000 000 000 000 000 000 000 000 000 
311 310 000 000 000 000 000 000 000 000 000 000 000 000 000 000 
311 310 000 000 000 000 000 000 000 000 000 000 000 000 000 000 
311 310 3d0 000 000 000 000 000 000 000 000 000 000 000 000 000 180
311 310 3e0 000 000 000 000 000 000 000 000 000 000 000 000 000 
311 310 000 000 000 000 000 000 000 000 000 000 000 000 000 000 
311 310 040 000 000 000 000 000 000 000 000 000 000 000 000 000 
321 320 040 040 000 000 000 000 000 000 000 000 000 000 000 000 
000 000 000 000 000 000 000 000 000 000 000 000 000 000 000 000 185
301 300 040 040 040 040 000 000 000 c06 000 000 000 000 000 000 
321 320 040 040 040 040 040 000 000 000 000 000 000 000 000 000 
000 000 000 000 000 000 000 000 000 000 000 000 000 000 000 000 
301 300 040 040 040 040 040 040 040 000 000 000 000 000 000 000 
311 310 040 040 040 040 040 040 040 040 000 000 000 000 000 000 190
311 310 040 040 040 040 040 040 040 040 000 000 000 000 000 000 
311 310 000 000 000 000 000 000 000 000 000 000 000 000 000 000 
311 310 000 000 000 000 000 000 000 000 000 000 000 000 000 000 
311 310 000 000 000 000 000 000 000 000 000 000 000 000 000 000 
311 310 000 000 000 000 000 000 000 000 000 000 000 000 000 000 195
311 310 000 000 000 000 000 000 000 000 000 000 000 000 000 000 
311 310 000 000 000 000 000 000 000 000 000 000 000 000 000 000 
311 310 000 000 000 000 000 000 000 000 000 000 000 000 000 000 
311 310 000 000 000 000 000 000 000 000 000 000 000 000 000 000 
311 310 0a4 81c 81c 81c 81c 81c 81c 81c 81c 81b 81a 000 000 000 200
311 310 000 000 000 000 000 000 000 000 000 0b1 0b0 006 006 006 
311 310 000 000 000 000 000 000 000 000 000 000 000 000 000 000 
311 310 000 000 000 000 000 000 000 000 000 000 000 000 000 000 
311 310 000 000 000 000 000 000 000 000 000 000 000 000 000 000 
311 310 000 000 000 000 000 000 000 000 000 000 000 000 000 000 205
311 310 0b4 0b3 0b2 000 000 000 000 000 000 000 000 000 000 000 
311 310 0c4 0c3 0c2 0c1 0c0 000 000 000 000 000 000 000 000 000 
311 310 0d4 0d3 0d2 0d1 0d0 000 000 000 000 000 000 000 000 000 
311 310 0e4 0e3 0e2 0e1 0e0 000 000 000 000 000 000 000 000 000 
311 310 0f4 0f3 0f2 000 000 000 000 000 000 000 000 000 000 000 210
311 310 000 000 000 000 000 000 000 000 000 000 000 000 000 000 
311 310 000 000 000 000 000 000 000 000 000 000 000 000 000 000 