0
211
16
1
144
600
0
0
0
0
0
0
111 110 000 000 000 000 000 000 000 000 000 000 000 000 000 000 
111 110 1f1 000 000 000 000 000 000 000 000 000 000 000 000 000 
111 110 000 000 000 000 000 000 000 000 000 000 000 000 000 000 
111 110 000 000 000 000 000 000 000 000 000 000 000 000 000 000 
111 110 1e8 1e7 000 000 000 000 000 000 000 000 000 000 000 000 5
111 110 1f8 1f7 000 000 000 000 000 000 000 000 000 000 000 000 
111 110 000 000 000 000 000 000 000 000 000 000 000 000 000 000 
111 110 000 000 000 000 000 000 000 000 000 000 000 000 000 000 
111 110 1d0 000 000 000 000 000 000 000 000 000 000 000 000 000 
111 110 1e0 000 000 000 000 000 000 000 000 000 000 000 000 000 10
111 110 1f0 000 000 000 000 000 000 000 000 000 000 000 000 000 
111 110 000 000 000 000 000 000 000 000 000 000 000 000 000 000 
111 110 000 000 000 000 000 000 000 000 000 000 000 000 000 000 
111 110 000 000 000 000 000 000 000 000 000 000 000 000 000 000 
111 110 000 000 000 000 000 000 000 000 000 000 000 000 000 000 15
111 110 000 000 000 000 000 000 000 000 000 000 000 000 000 000 
111 110 000 000 000 800 000 000 000 000 000 000 000 000 000 000 
111 110 000 000 000 000 000 000 000 000 000 000 000 000 000 000 
111 110 000 000 000 000 000 000 000 000 000 000 000 000 000 000 
111 110 000 000 000 000 000 000 000 000 000 000 000 000 000 000 20
111 110 c01 000 000 804 000 000 000 000 000 000 000 000 000 000 
111 110 000 000 000 800 000 000 000 000 000 000 000 000 000 000 
111 110 000 000 000 804 000 000 000 800 000 000 000 000 000 000 
111 110 000 000 000 801 000 000 000 000 000 000 000 000 000 000 
111 110 000 000 000 804 000 000 000 000 000 000 000 000 000 000 25
111 110 000 000 000 000 000 000 000 000 000 000 000 000 000 000 
111 110 000 000 000 000 000 000 000 000 000 000 000 000 000 000 
111 110 000 000 000 000 000 000 000 000 000 000 000 000 000 000 
111 110 002 001 000 000 000 000 000 000 000 000 000 000 000 000 
111 110 012 011 000 000 000 000 000 000 000 000 000 000 000 000 30
111 110 000 000 000 000 000 000 000 000 000 000 000 000 000 000 
111 110 000 000 000 000 000 000 000 000 000 000 000 000 000 000 
111 110 000 000 000 000 000 000 000 000 000 000 000 000 000 000 
111 110 000 000 000 000 000 000 000 000 000 000 000 000 000 000 
111 110 000 000 000 000 000 000 000 000 000 000 000 000 000 000 35
111 110 1f1 000 000 000 000 000 000 000 000 000 000 000 000 000 
111 110 000 000 000 000 000 000 000 000 000 000 000 000 000 000 
111 110 000 000 000 000 000 000 000 000 000 000 000 000 000 000 
111 110 002 002 001 000 000 000 000 000 000 000 000 000 000 000 
111 110 012 012 011 000 000 000 000 000 000 000 000 000 000 000 40
111 110 000 000 000 000 000 000 000 000 000 000 000 000 000 000 
111 110 c01 000 000 000 000 000 000 000 000 000 000 000 000 000 
111 110 000 000 000 000 000 000 000 000 000 000 000 000 000 000 
111 110 000 000 000 000 000 000 000 000 000 000 000 000 000 000 
111 110 000 000 000 000 000 000 000 000 000 000 000 000 000 000 45
111 110 000 000 000 000 000 000 000 000 000 000 000 000 000 000 
111 110 002 002 002 001 000 000 000 000 000 000 000 000 000 000 
111 110 012 012 012 011 000 000 000 000 000 000 000 000 000 000 
111 110 000 000 000 000 000 000 000 000 000 000 000 000 000 000 
111 110 000 000 000 000 000 000 000 000 000 000 000 000 000 000 50
111 110 c01 000 000 000 000 000 000 000 000 000 000 000 000 000 
111 110 000 000 000 000 000 000 000 000 000 000 000 000 000 000 
111 110 c01 000 000 000 000 000 000 000 000 000 000 000 000 000 
111 110 000 000 000 000 000 000 000 000 000 000 000 000 000 000 
111 110 000 000 000 000 000 000 000 000 000 000 000 000 000 000 55
111 110 000 000 000 000 000 000 000 000 000 000 000 000 000 000 
111 110 000 000 000 000 000 000 000 000 000 000 000 000 000 000 
111 110 002 002 002 81e 000 000 000 000 000 000 000 000 000 000 
111 110 012 012 012 81f 000 000 000 000 000 000 000 000 000 000 
111 110 000 000 000 000 000 000 000 000 000 000 000 000 000 000 60
111 110 000 000 000 000 000 000 000 000 000 000 000 000 000 000 
111 110 000 000 000 000 000 000 000 000 000 000 000 000 000 000 
111 110 000 000 000 000 000 000 000 000 000 000 000 000 000 000 
111 110 000 000 000 000 000 000 000 000 000 000 000 000 000 000 
111 110 000 000 000 80d 000 000 000 000 000 000 000 000 000 000 65
111 110 1d1 000 000 000 000 000 000 000 000 000 000 000 000 000 
111 110 1e1 000 000 000 000 000 000 000 000 000 000 000 000 000 
111 110 000 000 000 000 000 000 000 000 000 000 000 000 000 000 
121 120 000 000 000 000 000 000 000 000 000 000 000 000 000 000 
000 000 000 000 000 000 000 000 000 000 000 000 000 000 000 000 70
000 000 000 000 000 000 000 000 000 000 000 000 000 000 000 000 
101 100 000 000 000 000 000 000 000 000 000 000 000 000 000 000 
111 110 000 000 000 000 000 000 000 000 000 000 000 000 000 000 
111 110 000 000 000 000 000 000 000 000 000 000 000 000 000 000 
111 110 000 000 000 000 000 000 000 000 000 000 000 000 000 000 75
111 110 000 000 000 000 000 000 000 000 000 000 000 000 000 000 
111 110 000 000 000 000 000 000 000 000 000 000 000 000 000 000 
111 110 000 000 000 804 000 000 000 000 000 000 000 000 000 000 
111 110 000 000 000 801 000 000 000 000 000 000 000 000 000 000 
111 110 000 000 000 804 000 000 000 000 000 000 000 000 000 000 80
111 110 000 000 000 000 000 000 000 804 c01 000 000 000 000 000 
111 110 1d0 000 000 000 000 000 000 804 000 000 000 000 000 000 
111 110 1e0 000 000 000 000 000 000 804 c01 000 000 000 000 000 
111 110 1f0 000 000 000 000 000 000 804 000 000 000 000 000 000 
111 110 000 000 000 000 000 000 000 804 000 000 000 000 000 000 85
121 120 000 000 000 000 000 000 000 804 000 000 000 000 000 000 
000 000 000 000 000 000 000 000 000 804 000 000 000 000 000 000 
000 000 000 000 000 000 000 000 000 804 000 000 000 000 000 000 
000 000 000 000 000 000 000 000 000 804 000 000 000 000 000 000 
101 100 000 000 000 000 000 000 000 000 000 000 000 000 000 000 90
111 110 000 000 000 000 000 000 000 000 000 000 000 000 000 000 
111 110 000 000 000 000 000 000 000 804 000 000 000 000 000 000 
111 110 000 000 000 000 000 000 000 804 000 000 000 000 000 000 
111 110 000 000 000 000 000 000 000 804 000 000 000 000 000 000 
111 110 1f1 000 000 80e 000 000 000 800 000 000 000 000 000 000 95
111 110 000 000 000 000 000 000 000 000 000 000 000 000 000 000 
111 110 000 000 000 000 000 000 000 000 000 000 000 000 000 000 
111 110 c01 000 000 000 000 000 000 000 000 000 000 000 000 000 
111 110 000 000 000 000 000 000 000 000 000 000 000 000 000 000 
111 110 c01 000 000 000 000 000 000 000 000 000 000 000 000 000 100
111 110 000 000 000 804 000 000 000 000 000 000 000 000 000 000 
111 110 000 000 000 807 000 000 000 000 000 000 000 000 000 000 
111 110 000 000 000 000 000 000 000 000 000 000 000 000 000 000 
111 110 000 000 000 000 000 000 000 000 000 000 000 000 000 000 
111 110 1d2 000 000 000 000 000 000 000 000 000 000 000 000 000 105
111 110 1e2 000 000 000 000 000 000 000 000 000 000 000 000 000 
111 110 000 000 000 800 000 000 000 000 000 000 000 000 000 000 
111 110 c02 000 000 000 000 000 000 000 000 000 000 000 000 000 
111 110 000 000 000 000 000 000 000 000 000 000 000 000 000 000 
111 110 000 000 000 800 000 000 000 801 000 000 000 000 000 000 110
111 110 000 000 000 000 000 000 000 000 000 000 000 000 000 000 
111 110 000 000 000 000 000 000 000 000 000 000 000 000 000 000 
111 110 000 000 000 800 000 000 000 000 000 000 000 000 000 000 
111 110 000 000 000 000 000 000 000 000 000 000 000 000 000 000 
111 110 000 000 000 000 000 000 000 000 000 000 000 000 000 000 115
111 110 c01 000 000 000 000 000 000 000 000 000 000 000 000 000 
111 110 000 000 000 000 000 000 000 000 000 000 000 000 000 000 
111 110 c01 000 000 000 000 000 000 000 000 000 000 000 000 000 
111 110 000 000 000 804 000 000 000 000 000 000 000 000 000 000 
111 110 000 000 000 000 000 000 000 000 000 000 000 000 000 000 120
111 110 000 000 000 000 000 000 000 000 000 000 000 000 000 000 
111 110 000 000 000 000 000 000 000 804 000 000 000 000 000 000 
111 110 000 000 000 000 000 000 000 804 000 000 000 000 000 000 
111 110 000 000 000 000 000 000 000 804 000 000 000 000 000 000 
111 110 1f2 000 000 000 000 000 000 000 000 000 000 000 000 000 125
111 110 000 000 000 000 000 000 000 000 000 000 000 000 000 000 
111 110 c01 000 000 000 000 000 000 000 000 000 000 000 000 000 
111 110 000 000 000 000 000 000 000 000 000 000 000 000 000 000 
111 110 c01 000 000 000 000 000 000 804 000 000 000 000 000 000 
111 110 000 000 000 804 000 000 000 800 000 000 000 000 000 000 130
111 110 000 000 000 804 000 000 000 800 000 000 000 000 000 000 
111 110 c01 000 000 000 000 000 000 804 000 000 000 000 000 000 
111 110 000 000 000 000 000 000 000 000 000 000 000 000 000 000 
111 110 000 000 000 000 000 000 000 000 000 000 000 000 000 000 
111 110 040 000 000 000 000 000 000 000 000 000 000 000 000 000 135
111 110 040 040 000 000 000 000 000 000 000 000 000 000 000 000 
111 110 040 040 040 000 000 000 000 000 000 000 000 000 000 000 
111 110 040 040 040 040 000 000 000 000 000 000 000 000 000 000 
111 110 000 000 000 000 000 000 000 000 000 000 000 000 000 000 
111 110 000 000 000 000 000 000 000 000 000 000 000 000 000 000 140
111 110 040 040 040 040 000 000 000 000 000 000 000 000 000 000 
111 110 040 040 040 000 000 000 000 000 000 000 000 000 000 000 
111 110 040 040 000 000 000 000 000 000 000 000 000 000 000 000 
111 110 040 000 000 000 000 000 000 000 000 000 000 000 000 000 
111 110 000 000 000 000 000 000 000 000 000 000 000 000 000 000 145
111 110 1d1 000 000 000 000 000 000 000 000 000 000 000 000 000 
111 110 1e1 000 000 000 000 000 000 000 000 000 000 000 000 000 
111 110 000 000 000 000 000 000 000 000 000 000 000 000 000 000 
111 110 040 000 000 000 000 000 000 000 000 000 000 000 000 000 
111 110 040 040 000 000 000 000 000 000 000 000 000 000 000 000 150
111 110 040 040 040 000 000 000 000 000 000 000 000 000 000 000 
111 110 040 040 040 040 000 000 000 000 000 000 000 000 000 000 
121 120 040 040 040 040 000 000 000 000 000 000 000 000 000 000 
000 000 000 000 000 000 000 000 000 000 000 000 000 000 000 000 
000 000 000 000 000 000 000 000 000 000 000 000 000 000 000 000 155
101 100 040 040 040 040 000 000 000 000 000 000 000 000 000 000 
111 110 040 040 040 000 000 000 000 000 000 000 000 000 000 000 
111 110 040 040 000 000 000 000 000 000 000 000 000 000 000 000 
111 110 040 000 000 000 000 000 000 000 000 000 000 000 000 000 
111 110 000 000 000 000 000 000 000 000 000 000 000 000 000 000 160
111 110 000 000 000 000 000 000 000 000 000 000 000 000 000 000 
111 110 000 000 000 000 000 000 000 000 000 000 000 000 000 000 
111 110 000 000 000 000 000 000 000 000 000 000 000 000 000 000 
111 110 002 001 000 000 000 000 000 000 000 000 000 000 000 000 
111 110 012 011 000 000 000 000 000 000 000 000 000 000 000 000 165
111 110 000 000 000 000 000 000 000 000 000 000 000 000 000 000 
111 110 000 000 000 000 000 000 000 000 000 000 000 000 000 000 
111 110 000 000 000 000 000 000 000 000 000 000 000 000 000 000 
111 110 000 000 000 804 000 000 000 000 000 000 000 000 000 000 
111 110 000 000 000 804 000 000 000 000 000 000 000 000 000 000 170
111 110 000 000 000 800 000 000 000 000 000 000 000 000 000 000 
111 110 000 000 000 804 000 000 000 000 000 000 000 000 000 000 
111 110 000 000 000 000 000 000 000 000 000 000 000 000 000 000 
111 110 000 000 000 000 000 000 000 000 000 000 000 000 000 000 
111 110 c01 000 000 000 000 000 000 000 000 000 000 000 000 000 175
111 110 000 000 000 000 000 000 000 000 000 000 000 000 000 000 
111 110 c01 000 000 000 000 000 000 000 000 000 000 000 000 000 
111 110 000 000 000 000 000 000 000 000 000 000 000 000 000 000 
111 110 000 000 000 000 000 000 000 000 000 000 000 000 000 000 
111 110 002 001 000 000 000 000 000 000 000 000 000 000 000 000 180
111 110 012 011 000 000 000 000 000 000 000 000 000 000 000 000 
111 110 040 000 000 000 000 000 000 000 000 000 000 000 000 000 
111 110 040 040 000 000 000 000 000 000 000 000 000 000 000 000 
111 110 040 040 040 000 000 000 000 000 000 000 000 000 000 000 
111 110 040 040 040 040 000 000 000 000 000 000 000 000 000 000 185
111 110 040 040 040 040 040 000 000 000 000 000 000 000 000 000 
111 110 040 040 040 040 040 040 000 000 000 000 000 000 000 000 
111 110 040 040 040 040 040 040 040 000 000 000 000 000 000 000 
111 110 040 040 040 040 040 040 040 040 000 000 000 000 000 000 
111 110 040 040 040 040 040 040 040 040 000 000 000 000 000 000 190
111 110 000 000 000 000 000 000 000 000 000 000 000 000 000 000 
111 110 000 000 000 000 000 000 000 000 000 000 000 000 000 000 
111 110 000 000 000 000 000 000 000 000 000 000 000 000 000 000 
111 110 000 000 000 000 000 000 000 000 000 000 000 000 000 000 
111 110 000 000 000 000 000 000 000 000 000 000 000 000 000 000 195
111 110 000 000 000 000 000 000 000 000 000 000 000 000 000 000 
111 110 d02 000 000 000 000 000 000 000 000 000 000 000 000 000 
111 110 e02 000 000 000 000 000 000 000 000 000 000 000 000 000 
111 110 0a4 81c 81c 81c 81c 81c 81c 81c 81c 81b 81a 000 000 000 
111 110 000 000 000 000 000 000 000 000 000 0b1 0b0 006 006 006 200
111 110 000 000 000 000 000 000 000 000 000 000 000 000 000 000 
111 110 000 000 000 000 000 000 000 000 000 000 000 000 000 000 
111 110 000 000 000 000 000 000 000 000 000 000 000 000 000 000 
111 110 000 000 000 000 000 000 000 000 000 000 000 000 000 000 
111 110 0b4 0b3 0b2 000 000 000 000 000 000 000 000 000 000 000 205
111 110 0c4 0c3 0c2 0c1 0c0 000 000 000 000 000 000 000 000 000 
111 110 0d4 0d3 0d2 0d1 0d0 000 000 000 000 000 000 000 000 000 
111 110 0e4 0e3 0e2 0e1 0e0 000 000 000 000 000 000 000 000 000 
111 110 0f4 0f3 0f2 000 000 000 000 000 000 000 000 000 000 000 
111 110 000 000 000 000 000 000 000 000 000 000 000 000 000 000 210
111 110 000 000 000 000 000 000 000 000 000 000 000 000 000 000  
