1
21
16
0
7872
240
0
0
0
0
0
0
114 114 114 114 114 114 114 114 114 114 114 114 114 114 114 114 
114 144 124 124 124 124 124 124 124 124 124 124 124 124 124 124 
114 113 000 000 000 000 000 000 000 000 000 000 000 001 002 002 
114 113 000 000 000 000 000 000 000 000 000 000 000 011 012 012 
114 113 1f5 000 000 000 000 000 000 000 000 000 105 104 104 104 5
114 113 000 000 000 000 000 000 000 000 000 000 115 114 114 114 
114 113 804 804 804 81d 000 81d 000 000 000 000 115 114 114 114 
114 113 804 804 804 81d 000 81d 000 81d 000 000 115 114 114 114 
114 113 804 804 804 81d 000 81d 000 81d 000 000 115 114 114 114 
114 113 804 804 804 81d 000 81d 000 81d 000 000 115 114 114 114 10
114 113 804 804 804 81d 000 81d 000 81d 000 000 115 114 114 114 
114 113 804 804 804 81d 000 81d 000 81d 000 000 115 114 114 114 
114 113 804 804 804 81d 000 81d 000 000 000 000 115 114 114 114 
114 113 000 000 000 000 000 000 000 000 000 000 115 114 114 114 
114 113 000 000 000 000 000 000 000 000 000 000 115 114 114 114 15
114 113 820 021 000 000 000 000 000 000 000 000 115 114 114 114 
114 113 032 031 000 000 000 000 000 000 000 000 125 124 124 124 
114 113 082 081 002 002 002 002 002 002 002 002 002 002 002 002 
114 113 092 091 012 012 012 012 012 012 012 012 012 012 012 012 
114 154 104 104 104 104 104 104 104 104 104 104 104 104 104 104 20
114 114 114 114 114 114 114 114 114 114 114 114 114 114 114 114 