1
135
28
2
288
240
3
456
432
0
0
0
114 114 114 114 114 114 114 114 114 114 114 114 114 114 114 114 114 114 114 114 114 114 114 114 114 114 114 114 
114 114 144 124 124 124 124 124 124 124 124 124 124 124 124 124 124 124 124 124 124 124 124 124 124 124 124 124 
114 114 113 000 000 001 002 002 002 002 002 002 002 002 002 002 002 002 002 002 002 002 002 002 002 002 002 002 
114 114 113 000 000 011 012 012 012 012 012 012 012 012 012 012 012 012 012 012 012 012 012 012 012 012 012 012 
114 114 113 000 000 105 104 104 104 104 104 104 104 104 104 104 104 104 104 104 104 104 104 104 104 104 104 104 5
114 114 113 000 000 115 114 114 114 114 114 114 114 114 114 114 114 114 114 114 114 114 114 114 114 114 114 114 
114 114 113 000 000 115 114 114 114 114 114 114 114 114 114 114 114 114 114 114 114 114 114 114 114 114 114 114 
114 114 113 000 000 115 114 114 114 114 114 114 114 114 114 114 114 114 114 114 114 114 114 114 114 114 114 114 
114 114 113 1d4 000 115 114 114 114 114 114 114 114 114 114 114 114 114 114 114 114 114 114 114 114 114 114 114 
114 114 113 1e4 000 125 124 124 124 124 124 124 124 124 124 184 114 114 114 114 114 114 114 114 114 114 114 114 10
114 114 113 000 000 000 000 000 000 000 000 000 000 000 000 115 114 114 114 114 114 114 114 114 114 114 114 114 
114 114 113 000 000 000 000 000 000 000 000 000 000 000 000 115 114 114 114 114 114 114 114 114 114 114 114 114 
114 114 261 260 000 000 000 000 000 000 000 000 000 000 000 115 114 114 114 114 114 114 114 114 114 114 114 114 
114 114 114 261 260 000 000 000 000 000 000 000 000 000 000 115 114 114 114 114 114 114 114 114 114 114 114 114 
114 114 114 114 261 260 000 000 000 000 000 000 000 000 000 115 114 114 114 114 114 114 114 114 114 114 114 114 15
114 114 114 114 114 261 260 000 000 000 000 000 000 000 000 115 114 114 114 114 114 114 114 114 114 114 114 114 
114 114 114 114 114 114 261 260 000 000 000 000 000 000 000 115 114 114 114 114 114 114 114 114 114 114 114 114 
114 114 114 114 114 114 114 261 260 000 000 000 000 000 000 115 114 114 114 114 114 114 114 114 114 114 114 114 
114 114 114 114 114 114 114 114 113 000 000 000 000 000 000 115 114 114 114 114 114 114 114 114 114 114 114 114 
114 114 114 114 114 114 114 114 113 804 804 804 c0c 000 000 115 114 114 114 114 114 114 114 114 114 114 114 114 20
114 114 114 114 114 114 114 114 113 000 000 801 000 000 000 115 114 114 114 114 114 114 114 114 114 114 114 114 
114 114 114 114 114 114 114 114 113 1f5 000 000 000 000 000 115 114 114 114 114 114 114 114 114 114 114 114 114 
114 114 114 114 114 114 114 114 113 c0c 000 000 000 000 000 115 114 114 114 114 114 114 114 114 114 114 114 114 
114 114 114 114 114 114 114 114 113 804 804 000 000 000 000 115 114 114 114 114 114 114 114 114 114 114 114 114 
114 114 114 114 114 114 114 114 113 000 000 000 000 000 000 115 114 114 114 114 114 114 114 114 114 114 114 114 25
114 114 114 114 114 114 114 114 2a0 000 000 000 000 000 000 115 114 114 114 114 114 114 114 114 114 114 114 114 
114 114 114 114 114 114 114 2b1 2b0 000 000 000 000 000 000 115 114 114 114 114 114 114 114 114 114 114 114 114 
114 114 114 114 114 114 114 2a0 000 000 000 000 000 000 000 115 114 114 114 114 114 114 114 114 114 114 114 114 
114 114 114 114 114 114 2b1 2b0 000 000 000 000 000 000 000 115 114 114 114 114 114 114 114 114 114 114 114 114 
114 114 114 114 114 114 2a0 000 000 000 283 103 000 000 000 115 114 114 114 114 114 114 114 114 114 114 114 114 30
114 114 114 114 114 2b1 2b0 000 000 000 293 113 000 000 000 115 144 124 124 124 184 114 114 114 114 114 114 114 
114 114 114 114 114 2a0 000 000 000 000 115 113 000 000 000 115 113 000 000 000 115 114 114 114 114 114 114 114 
114 114 114 114 2b1 2b0 000 000 000 000 115 113 000 000 000 115 113 000 000 000 115 114 114 114 114 114 114 114 
114 114 114 114 2a0 000 000 000 000 000 115 113 000 000 000 115 113 000 000 000 115 114 114 114 114 114 114 114 
114 114 114 2b1 2b0 000 000 000 000 000 115 113 000 000 000 115 113 000 000 000 115 114 114 114 114 114 114 114 35
114 114 114 2a0 000 000 000 000 000 000 115 113 1d4 000 000 115 113 000 000 000 115 114 114 114 114 114 114 114 
114 114 2b1 2b0 000 000 000 000 000 000 115 113 1e4 000 000 115 113 000 000 000 115 114 114 114 114 114 114 114 
114 114 2a0 000 000 000 000 000 000 000 115 113 000 000 000 115 113 c0c 000 000 115 114 114 114 114 114 114 114 
114 2b1 2b0 000 000 000 000 000 000 000 115 113 c0c 000 000 115 113 000 000 000 115 114 114 114 114 114 114 114 
114 113 000 000 000 283 103 000 000 000 115 154 104 104 104 194 113 000 000 000 115 114 114 114 114 114 114 114 40
114 113 c0c 000 000 293 113 000 000 000 115 114 114 114 114 271 113 000 000 000 115 114 114 114 114 114 114 114 
114 113 000 000 000 115 113 000 000 000 115 144 124 124 124 184 113 000 000 000 115 114 114 114 114 114 114 114 
114 113 000 000 000 115 113 000 000 000 115 113 000 000 000 115 113 000 000 000 115 114 114 114 114 114 114 114 
114 113 000 000 000 115 113 000 000 000 115 113 000 000 000 115 113 000 000 000 115 114 114 114 114 114 114 114 
114 113 000 000 000 115 113 000 000 000 115 113 000 000 000 115 113 c0c 000 000 115 114 114 114 114 114 114 114 45
114 113 000 000 000 115 113 000 000 000 115 113 000 000 000 115 113 000 000 000 115 114 114 114 114 114 114 114 
114 113 000 000 000 115 113 1d3 000 000 115 113 000 000 000 115 113 000 000 000 115 114 114 114 114 114 114 114 
114 113 804 804 804 115 113 1e3 000 000 115 113 000 000 000 115 113 000 000 000 115 114 114 114 114 114 114 114 
114 113 000 000 000 115 113 1f3 000 000 115 113 000 000 000 115 113 000 000 000 115 114 114 114 114 114 114 114 
114 113 000 000 000 115 113 000 000 000 115 113 000 000 000 115 113 000 000 000 115 114 114 114 114 114 114 114 50
114 113 1f4 000 000 115 113 000 000 000 125 123 000 000 000 115 113 000 000 000 115 114 114 114 114 114 114 114 
114 113 000 000 000 115 113 000 000 000 000 000 000 000 000 115 154 104 104 104 194 114 114 114 114 114 114 114 
114 113 000 000 000 115 113 044 043 c03 000 000 000 000 000 115 114 114 114 114 114 114 114 114 114 114 114 114 
114 113 000 000 000 115 113 054 053 000 000 000 000 000 000 115 144 124 124 124 184 114 114 114 114 114 114 114 
114 113 000 000 000 115 113 000 000 000 000 000 000 000 000 115 113 000 000 000 115 114 114 114 114 114 114 114 55
114 113 c0c 000 000 115 113 000 000 000 105 103 000 000 000 115 113 000 000 000 115 114 114 114 114 114 114 114 
114 113 000 000 000 115 113 000 000 000 115 113 000 000 000 125 123 000 000 040 125 124 124 124 124 124 124 114 
114 154 104 104 104 194 113 000 000 000 115 113 000 000 000 000 000 000 000 040 000 000 000 81e 002 002 002 114 
114 114 114 114 114 114 113 000 000 000 115 113 040 000 000 000 000 000 000 040 000 000 000 81f 012 012 012 114 
114 114 114 114 114 114 113 000 000 000 115 113 040 000 000 000 000 000 000 040 000 000 000 000 000 000 105 114 60
114 114 114 114 114 114 113 000 000 000 115 113 000 000 000 000 000 000 000 040 040 040 040 040 000 000 115 114 
114 114 114 114 114 114 113 000 000 000 115 113 000 000 000 105 280 000 000 000 000 000 000 000 000 000 115 114 
114 114 114 114 114 114 113 c0c 000 000 115 113 000 000 000 115 290 000 000 000 000 000 000 000 000 000 115 114 
114 114 114 114 114 114 113 000 000 000 115 113 000 000 000 115 113 000 000 000 80a 000 000 000 000 000 115 114 
114 114 114 114 114 114 154 104 104 104 194 113 1f5 000 000 115 113 000 000 000 000 000 000 000 000 000 115 114 65
114 114 114 114 114 114 114 114 114 114 114 113 000 000 000 115 113 000 000 000 000 000 000 000 000 000 115 114 
114 114 114 114 114 114 114 114 114 114 114 113 000 000 000 115 113 000 000 000 000 000 000 000 000 000 115 114 
114 114 114 114 114 114 114 114 114 114 114 113 c0c 000 000 115 113 000 000 000 000 000 000 000 000 000 115 114 
114 114 114 114 114 114 114 114 114 114 114 154 104 104 104 194 113 000 000 000 000 000 000 000 000 000 115 114 
114 114 114 114 114 114 114 114 114 114 114 114 114 114 114 271 270 000 000 000 000 000 000 000 000 000 115 114 70
114 114 114 114 114 114 114 114 114 114 114 114 114 114 271 270 000 000 000 000 000 000 263 104 104 104 194 114 
114 114 114 114 114 114 114 114 114 114 114 114 114 271 270 000 000 000 000 000 000 263 262 114 114 114 114 114 
114 114 114 114 114 114 114 114 114 114 114 114 271 270 000 000 000 000 000 000 263 262 114 114 114 114 114 114 
114 114 114 114 114 114 114 114 114 114 114 271 270 000 000 000 000 000 000 263 262 114 114 114 114 114 114 114 
114 114 114 114 114 114 114 114 114 114 271 270 000 000 000 000 000 000 263 262 114 114 114 114 114 114 114 114 75
114 114 114 114 114 114 114 114 114 271 270 000 000 000 000 000 000 263 262 114 114 114 114 114 114 114 114 114 
114 114 114 114 114 114 114 114 271 270 000 000 000 000 000 000 263 262 114 114 114 114 114 114 114 114 114 114 
114 114 114 114 114 114 114 271 270 000 000 000 000 000 000 000 115 114 114 114 114 114 114 114 114 114 114 114 
114 114 114 114 114 114 271 270 000 000 000 000 000 000 000 000 115 114 114 114 114 114 114 114 114 114 114 114 
114 114 114 114 114 271 270 c0c 000 000 000 000 000 000 000 000 115 114 114 114 114 114 114 114 114 114 114 114 80
114 114 114 114 271 270 000 000 000 000 000 000 000 000 000 000 115 114 114 114 114 114 114 114 114 114 114 114 
114 114 114 271 270 000 000 000 000 000 000 000 000 000 000 000 115 114 114 114 114 114 114 114 114 114 114 114 
114 114 271 270 c0c 000 000 000 000 000 000 000 000 000 000 000 115 114 114 114 114 114 114 114 114 114 114 114 
114 271 270 000 000 000 000 000 000 000 000 000 000 000 000 000 115 114 114 114 114 114 114 114 114 114 114 114 
124 270 000 000 000 000 000 000 000 000 000 000 000 000 000 000 115 114 114 114 114 114 114 114 114 114 114 114 85
000 000 000 000 000 000 000 000 000 000 000 000 000 000 000 000 115 114 114 114 114 114 114 114 114 114 114 114 
002 002 001 000 000 000 000 000 000 000 000 000 000 000 000 000 115 114 114 114 114 114 114 114 114 114 114 114 
012 012 011 000 000 000 000 000 000 000 000 000 000 000 000 000 115 114 114 114 114 114 114 114 114 114 114 114 
104 104 104 104 291 260 000 000 000 000 000 000 000 000 000 000 115 114 114 114 114 114 114 114 114 114 114 114 
114 114 114 114 114 261 260 000 000 000 000 000 000 000 000 000 115 114 114 114 114 114 114 114 114 114 114 114 90
114 114 114 114 114 114 261 260 000 000 000 000 000 000 000 000 115 114 114 114 114 114 114 114 114 114 114 114 
114 114 114 114 114 114 114 261 260 000 000 000 000 000 000 000 115 114 114 114 114 114 114 114 114 114 114 114 
114 114 114 114 114 114 114 114 261 260 000 000 000 000 000 000 115 114 114 114 114 114 114 114 114 114 114 114 
114 114 114 114 114 114 114 114 114 261 260 000 000 000 000 000 115 114 114 114 114 114 114 114 114 114 114 114 
114 114 114 114 114 114 114 114 114 114 113 000 000 000 000 000 115 114 114 114 114 114 114 114 114 114 114 114 95
114 114 114 114 114 114 114 114 114 114 113 000 000 000 000 000 115 114 114 114 114 114 114 114 114 114 114 114 
114 114 114 114 114 114 114 114 114 114 113 000 000 000 000 000 115 114 114 114 114 114 114 114 114 114 114 114 
114 114 114 114 114 114 114 114 114 114 113 000 000 000 000 000 115 114 114 114 114 114 114 114 114 114 114 114 
114 114 114 114 114 114 114 114 114 114 154 103 000 000 000 000 115 114 114 114 114 114 114 114 114 114 114 114 
114 114 114 114 114 114 114 114 114 114 114 113 000 000 000 000 115 114 114 114 114 114 114 114 114 114 114 114 100
114 114 114 114 114 114 114 114 114 114 114 113 1d4 000 000 000 115 114 114 114 114 114 114 114 114 114 114 114 
114 114 114 114 114 114 114 114 114 114 114 113 1e4 000 000 000 115 114 114 114 114 114 114 114 114 114 114 114 
114 114 114 114 114 114 114 114 114 114 114 113 000 000 000 000 115 114 114 114 114 114 114 114 114 114 114 114 
114 114 114 114 114 114 114 114 114 114 114 113 000 000 000 000 115 114 114 114 114 114 114 114 114 114 114 114 
114 114 114 114 114 114 114 114 114 114 114 113 c0c 000 000 000 115 114 114 114 114 114 114 114 114 114 114 114 105
114 114 114 114 114 114 114 114 114 114 114 113 000 000 000 000 115 114 114 114 114 114 114 114 114 114 114 114 
114 114 114 114 114 114 114 114 114 114 114 113 000 000 000 000 115 114 114 114 114 114 114 114 114 114 114 114 
114 114 114 114 114 114 114 114 114 114 114 113 000 000 000 000 115 114 114 114 114 114 114 114 114 114 114 114 
114 114 114 114 114 114 114 114 114 114 114 113 c0c 000 000 000 115 114 114 114 114 114 114 114 114 114 114 114 
114 114 114 114 114 114 114 114 114 114 114 113 000 000 000 000 115 114 114 114 114 114 114 114 114 114 114 114 110
114 114 114 114 114 114 114 114 114 114 114 113 000 000 000 000 115 114 114 114 114 114 114 114 114 114 114 114 
114 114 114 114 114 114 114 114 114 114 114 113 000 000 000 000 115 114 114 114 114 114 114 114 114 114 114 114 
114 114 114 114 114 114 114 114 114 114 114 113 000 000 000 000 115 114 114 114 114 114 114 114 114 114 114 114 
114 114 114 114 114 114 114 114 114 114 271 270 000 000 000 000 115 114 114 114 114 114 114 114 114 114 114 114 
114 114 114 114 114 114 114 114 114 114 113 000 000 000 000 000 115 114 114 114 114 114 114 114 114 114 114 114 115
114 114 114 114 114 114 114 114 114 114 113 000 000 000 000 000 115 114 114 114 114 114 114 114 114 114 114 114 
114 114 114 114 114 114 114 114 114 114 113 000 000 804 804 804 115 114 114 114 114 114 114 114 114 114 114 114 
114 114 114 114 114 114 114 114 114 114 113 000 000 000 000 000 115 114 114 114 114 114 114 114 114 114 114 114 
114 114 114 114 114 114 114 114 114 114 113 000 000 000 000 000 115 114 114 114 114 114 114 114 114 114 114 114 
114 114 114 114 114 114 114 114 114 114 113 044 043 c03 000 000 115 114 114 114 114 114 114 114 114 114 114 114 120
114 114 114 114 114 114 114 114 114 114 113 054 053 000 000 000 115 114 114 114 114 114 114 114 114 114 114 114 
114 114 114 114 114 114 114 114 114 114 154 104 103 000 000 000 115 114 114 114 114 114 114 114 114 114 114 114 
114 114 114 114 114 114 114 114 114 114 114 114 113 000 000 000 115 114 114 114 114 114 114 114 114 114 114 114 
114 114 114 114 114 114 114 114 114 114 114 114 113 000 000 000 115 114 114 114 114 114 114 114 114 114 114 114 
114 114 114 114 114 114 114 114 114 114 114 114 113 1d3 000 000 115 114 114 114 114 114 114 114 114 114 114 114 125
114 114 114 114 114 114 114 114 114 114 114 114 113 1e3 000 000 115 114 114 114 114 114 114 114 114 114 114 114 
114 114 114 114 114 114 114 114 114 114 114 114 113 1f3 000 000 115 114 114 114 114 114 114 114 114 114 114 114 
114 114 114 114 114 114 114 114 114 114 114 114 113 000 000 000 115 114 114 114 114 114 114 114 114 114 114 114 
114 114 114 114 114 114 114 114 114 114 114 114 113 000 000 000 115 114 114 114 114 114 114 114 114 114 114 114 
114 114 114 114 114 114 114 114 114 114 114 114 113 000 000 000 125 124 124 124 124 124 124 124 124 124 124 124 130
114 114 114 114 114 114 114 114 114 114 114 114 113 000 000 000 821 002 002 002 002 002 002 002 002 002 002 002 
114 114 114 114 114 114 114 114 114 114 114 114 113 000 000 000 822 012 012 012 012 012 012 012 012 012 012 012 
114 114 114 114 114 114 114 114 114 114 114 114 154 104 104 104 104 104 104 104 104 104 104 104 104 104 104 104 
114 114 114 114 114 114 114 114 114 114 114 114 114 114 114 114 114 114 114 114 114 114 114 114 114 114 114 114 
114 114 114 114 114 114 114 114 114 114 114 114 114 114 114 114 114 114 114 114 114 114 114 114 114 114 114 114 135
